############
#p ##  #  ##
#   ##   ###
###     # ##
#### ##    #
#      #  ##
#  ### #e###
##   e# # ##
## #  ### ##
#  ##  #  ##
# e### # ###
############